Microsoft Windows [Version 10.0.19043.1081]
(c) Microsoft Corporation. All rights reserved.

C:\Users\Anon>node.js --version
'node.js' is not recognized as an internal or external command,
operable program or batch file.

C:\Users\Anon>cordova --version
'cordova' is not recognized as an internal or external command,
operable program or batch file.

C:\Users\Anon>nodejs --version
'nodejs' is not recognized as an internal or external command,
operable program or batch file.

C:\Users\Anon>npm install -g @ionic/cli
C:\Users\Anon\AppData\Roaming\npm\ionic -> C:\Users\Anon\AppData\Roaming\npm\node_modules\@ionic\cli\bin\ionic
+ @ionic/cli@6.16.3
added 212 packages from 156 contributors in 17.513s

C:\Users\Anon>cordova --version
'cordova' is not recognized as an internal or external command,
operable program or batch file.

C:\Users\Anon>cordova
'cordova' is not recognized as an internal or external command,
operable program or batch file.

C:\Users\Anon>phonegap
'phonegap' is not recognized as an internal or external command,
operable program or batch file.

C:\Users\Anon>ionic start myApp tabs

Pick a framework!

Please select the JavaScript framework to use for your new app. To bypass this prompt
next time, supply a value for the --type option.

? Framework: Angular
√ Preparing directory .\myApp in 1.74ms
√ Downloading and extracting tabs starter in 276.80ms
? Integrate your new app with Capacitor to target native iOS and Android? No

Installing dependencies may take several minutes.

  ──────────────────────────────────────────────────────────────────────────────

         Ionic Advisory, tailored solutions and expert services by Ionic

                             Go to market faster
                    Real-time troubleshooting and guidance
        Custom training, best practices, code and architecture reviews
      Customized strategies for every phase of the development lifecycle

               Learn more: https://ion.link/advisory

  ──────────────────────────────────────────────────────────────────────────────


> npm.cmd i
npm WARN deprecated chokidar@2.1.8: Chokidar 2 will break on node v14+. Upgrade to chokidar 3 with 15x less dependencies.
npm WARN deprecated request@2.88.2: request has been deprecated, see https://github.com/request/request/issues/3142
npm WARN deprecated fsevents@1.2.13: fsevents 1 will break on node v14+ and could be using insecure binaries. Upgrade to fsevents 2.
npm WARN deprecated uuid@3.4.0: Please upgrade  to version 7 or higher.  Older versions may use Math.random() in certain circumstances, which is known to be problematic.  See https://v8.dev/blog/math-random for details.
npm WARN deprecated querystring@0.2.0: The
npm WARN deprecated har-validator@5.1.5: this library is no longer supported
npm WARN deprecated urix@0.1.0: Please see https://github.com/lydell/urix#deprecated
npm WARN deprecated resolve-url@0.2.1: https://github.com/lydell/resolve-url#deprecated

> core-js@3.12.0 postinstall C:\Users\Anon\myApp\node_modules\core-js
> node -e "try{require('./postinstall')}catch(e){}"

Thank you for using core-js ( https://github.com/zloirock/core-js ) for polyfilling JavaScript standard library!

The project needs your help! Please consider supporting of core-js on Open Collective or Patreon:
> https://opencollective.com/core-js
> https://www.patreon.com/zloirock

Also, the author of core-js ( https://github.com/zloirock ) is looking for a good job -)


> core-js-pure@3.15.2 postinstall C:\Users\Anon\myApp\node_modules\core-js-pure
> node -e "try{require('./postinstall')}catch(e){}"


> @angular/cli@12.0.5 postinstall C:\Users\Anon\myApp\node_modules\@angular\cli
> node ./bin/postinstall/script.js

? Would you like to share anonymous usage data with the Angular Team at Google under
Google’s Privacy Policy at https://policies.google.com/privacy? For more details and
how to change this setting, see https://angular.io/analytics. No
npm notice created a lockfile as package-lock.json. You should commit this file.
npm WARN optional SKIPPING OPTIONAL DEPENDENCY: fsevents@~2.3.2 (node_modules\chokidar\node_modules\fsevents):
npm WARN notsup SKIPPING OPTIONAL DEPENDENCY: Unsupported platform for fsevents@2.3.2: wanted {"os":"darwin","arch":"any"} (current: {"os":"win32","arch":"x64"})
npm WARN optional SKIPPING OPTIONAL DEPENDENCY: fsevents@^1.2.7 (node_modules\webpack-dev-server\node_modules\chokidar\node_modules\fsevents):
npm WARN notsup SKIPPING OPTIONAL DEPENDENCY: Unsupported platform for fsevents@1.2.13: wanted {"os":"darwin","arch":"any"} (current: {"os":"win32","arch":"x64"})
npm WARN ajv-keywords@3.5.2 requires a peer of ajv@^6.9.1 but none is installed. You must install peer dependencies yourself.

added 1592 packages from 1312 contributors and audited 1597 packages in 125.667s

128 packages are looking for funding
  run `npm fund` for details

found 2 vulnerabilities (1 moderate, 1 high)
  run `npm audit fix` to fix them, or `npm audit` for details
> git.exe init
Initialized empty Git repository in C:/Users/Anon/myApp/.git/

Join the Ionic Community! 💙

Connect with millions of developers on the Ionic Forum and get access to live events,
news updates, and more.

? Create free Ionic account? No
> git.exe add -A
warning: LF will be replaced by CRLF in .browserslistrc.
The file will have its original line endings in your working directory
warning: LF will be replaced by CRLF in .editorconfig.
The file will have its original line endings in your working directory
warning: LF will be replaced by CRLF in .eslintrc.json.
The file will have its original line endings in your working directory
warning: LF will be replaced by CRLF in .gitignore.
The file will have its original line endings in your working directory
warning: LF will be replaced by CRLF in angular.json.
The file will have its original line endings in your working directory
warning: LF will be replaced by CRLF in e2e/protractor.conf.js.
The file will have its original line endings in your working directory
warning: LF will be replaced by CRLF in e2e/src/app.e2e-spec.ts.
The file will have its original line endings in your working directory
warning: LF will be replaced by CRLF in e2e/src/app.po.ts.
The file will have its original line endings in your working directory
warning: LF will be replaced by CRLF in e2e/tsconfig.json.
The file will have its original line endings in your working directory
warning: LF will be replaced by CRLF in ionic.config.json.
The file will have its original line endings in your working directory
warning: LF will be replaced by CRLF in karma.conf.js.
The file will have its original line endings in your working directory
warning: LF will be replaced by CRLF in package-lock.json.
The file will have its original line endings in your working directory
warning: LF will be replaced by CRLF in package.json.
The file will have its original line endings in your working directory
warning: LF will be replaced by CRLF in src/app/app-routing.module.ts.
The file will have its original line endings in your working directory
warning: LF will be replaced by CRLF in src/app/app.component.html.
The file will have its original line endings in your working directory
warning: LF will be replaced by CRLF in src/app/app.component.spec.ts.
The file will have its original line endings in your working directory
warning: LF will be replaced by CRLF in src/app/app.component.ts.
The file will have its original line endings in your working directory
warning: LF will be replaced by CRLF in src/app/app.module.ts.
The file will have its original line endings in your working directory
warning: LF will be replaced by CRLF in src/app/explore-container/explore-container.component.html.
The file will have its original line endings in your working directory
warning: LF will be replaced by CRLF in src/app/explore-container/explore-container.component.scss.
The file will have its original line endings in your working directory
warning: LF will be replaced by CRLF in src/app/explore-container/explore-container.component.spec.ts.
The file will have its original line endings in your working directory
warning: LF will be replaced by CRLF in src/app/explore-container/explore-container.component.ts.
The file will have its original line endings in your working directory
warning: LF will be replaced by CRLF in src/app/explore-container/explore-container.module.ts.
The file will have its original line endings in your working directory
warning: LF will be replaced by CRLF in src/app/tab1/tab1-routing.module.ts.
The file will have its original line endings in your working directory
warning: LF will be replaced by CRLF in src/app/tab1/tab1.module.ts.
The file will have its original line endings in your working directory
warning: LF will be replaced by CRLF in src/app/tab1/tab1.page.html.
The file will have its original line endings in your working directory
warning: LF will be replaced by CRLF in src/app/tab1/tab1.page.spec.ts.
The file will have its original line endings in your working directory
warning: LF will be replaced by CRLF in src/app/tab1/tab1.page.ts.
The file will have its original line endings in your working directory
warning: LF will be replaced by CRLF in src/app/tab2/tab2-routing.module.ts.
The file will have its original line endings in your working directory
warning: LF will be replaced by CRLF in src/app/tab2/tab2.module.ts.
The file will have its original line endings in your working directory
warning: LF will be replaced by CRLF in src/app/tab2/tab2.page.html.
The file will have its original line endings in your working directory
warning: LF will be replaced by CRLF in src/app/tab2/tab2.page.spec.ts.
The file will have its original line endings in your working directory
warning: LF will be replaced by CRLF in src/app/tab2/tab2.page.ts.
The file will have its original line endings in your working directory
warning: LF will be replaced by CRLF in src/app/tab3/tab3-routing.module.ts.
The file will have its original line endings in your working directory
warning: LF will be replaced by CRLF in src/app/tab3/tab3.module.ts.
The file will have its original line endings in your working directory
warning: LF will be replaced by CRLF in src/app/tab3/tab3.page.html.
The file will have its original line endings in your working directory
warning: LF will be replaced by CRLF in src/app/tab3/tab3.page.spec.ts.
The file will have its original line endings in your working directory
warning: LF will be replaced by CRLF in src/app/tab3/tab3.page.ts.
The file will have its original line endings in your working directory
warning: LF will be replaced by CRLF in src/app/tabs/tabs-routing.module.ts.
The file will have its original line endings in your working directory
warning: LF will be replaced by CRLF in src/app/tabs/tabs.module.ts.
The file will have its original line endings in your working directory
warning: LF will be replaced by CRLF in src/app/tabs/tabs.page.html.
The file will have its original line endings in your working directory
warning: LF will be replaced by CRLF in src/app/tabs/tabs.page.scss.
The file will have its original line endings in your working directory
warning: LF will be replaced by CRLF in src/app/tabs/tabs.page.spec.ts.
The file will have its original line endings in your working directory
warning: LF will be replaced by CRLF in src/app/tabs/tabs.page.ts.
The file will have its original line endings in your working directory
warning: LF will be replaced by CRLF in src/assets/shapes.svg.
The file will have its original line endings in your working directory
warning: LF will be replaced by CRLF in src/environments/environment.prod.ts.
The file will have its original line endings in your working directory
warning: LF will be replaced by CRLF in src/environments/environment.ts.
The file will have its original line endings in your working directory
warning: LF will be replaced by CRLF in src/global.scss.
The file will have its original line endings in your working directory
warning: LF will be replaced by CRLF in src/index.html.
The file will have its original line endings in your working directory
warning: LF will be replaced by CRLF in src/main.ts.
The file will have its original line endings in your working directory
warning: LF will be replaced by CRLF in src/polyfills.ts.
The file will have its original line endings in your working directory
warning: LF will be replaced by CRLF in src/test.ts.
The file will have its original line endings in your working directory
warning: LF will be replaced by CRLF in src/theme/variables.scss.
The file will have its original line endings in your working directory
warning: LF will be replaced by CRLF in src/zone-flags.ts.
The file will have its original line endings in your working directory
warning: LF will be replaced by CRLF in tsconfig.app.json.
The file will have its original line endings in your working directory
warning: LF will be replaced by CRLF in tsconfig.json.
The file will have its original line endings in your working directory
warning: LF will be replaced by CRLF in tsconfig.spec.json.
The file will have its original line endings in your working directory
> git.exe commit -m "Initial commit" --no-gpg-sign
[master (root-commit) cbf7c23] Initial commit
 62 files changed, 16087 insertions(+)
 create mode 100644 .browserslistrc
 create mode 100644 .editorconfig
 create mode 100644 .eslintrc.json
 create mode 100644 .gitignore
 create mode 100644 angular.json
 create mode 100644 e2e/protractor.conf.js
 create mode 100644 e2e/src/app.e2e-spec.ts
 create mode 100644 e2e/src/app.po.ts
 create mode 100644 e2e/tsconfig.json
 create mode 100644 ionic.config.json
 create mode 100644 karma.conf.js
 create mode 100644 package-lock.json
 create mode 100644 package.json
 create mode 100644 src/app/app-routing.module.ts
 create mode 100644 src/app/app.component.html
 create mode 100644 src/app/app.component.scss
 create mode 100644 src/app/app.component.spec.ts
 create mode 100644 src/app/app.component.ts
 create mode 100644 src/app/app.module.ts
 create mode 100644 src/app/explore-container/explore-container.component.html
 create mode 100644 src/app/explore-container/explore-container.component.scss
 create mode 100644 src/app/explore-container/explore-container.component.spec.ts
 create mode 100644 src/app/explore-container/explore-container.component.ts
 create mode 100644 src/app/explore-container/explore-container.module.ts
 create mode 100644 src/app/tab1/tab1-routing.module.ts
 create mode 100644 src/app/tab1/tab1.module.ts
 create mode 100644 src/app/tab1/tab1.page.html
 create mode 100644 src/app/tab1/tab1.page.scss
 create mode 100644 src/app/tab1/tab1.page.spec.ts
 create mode 100644 src/app/tab1/tab1.page.ts
 create mode 100644 src/app/tab2/tab2-routing.module.ts
 create mode 100644 src/app/tab2/tab2.module.ts
 create mode 100644 src/app/tab2/tab2.page.html
 create mode 100644 src/app/tab2/tab2.page.scss
 create mode 100644 src/app/tab2/tab2.page.spec.ts
 create mode 100644 src/app/tab2/tab2.page.ts
 create mode 100644 src/app/tab3/tab3-routing.module.ts
 create mode 100644 src/app/tab3/tab3.module.ts
 create mode 100644 src/app/tab3/tab3.page.html
 create mode 100644 src/app/tab3/tab3.page.scss
 create mode 100644 src/app/tab3/tab3.page.spec.ts
 create mode 100644 src/app/tab3/tab3.page.ts
 create mode 100644 src/app/tabs/tabs-routing.module.ts
 create mode 100644 src/app/tabs/tabs.module.ts
 create mode 100644 src/app/tabs/tabs.page.html
 create mode 100644 src/app/tabs/tabs.page.scss
 create mode 100644 src/app/tabs/tabs.page.spec.ts
 create mode 100644 src/app/tabs/tabs.page.ts
 create mode 100644 src/assets/icon/favicon.png
 create mode 100644 src/assets/shapes.svg
 create mode 100644 src/environments/environment.prod.ts
 create mode 100644 src/environments/environment.ts
 create mode 100644 src/global.scss
 create mode 100644 src/index.html
 create mode 100644 src/main.ts
 create mode 100644 src/polyfills.ts
 create mode 100644 src/test.ts
 create mode 100644 src/theme/variables.scss
 create mode 100644 src/zone-flags.ts
 create mode 100644 tsconfig.app.json
 create mode 100644 tsconfig.json
 create mode 100644 tsconfig.spec.json

Your Ionic app is ready! Follow these next steps:

- Go to your new project: cd .\myApp
- Run ionic serve within the app directory to see your app in the browser
- Run ionic capacitor add to add a native iOS or Android project using Capacitor
- Generate your app icon and splash screens using cordova-res --skip-config --copy
- Explore the Ionic docs for components, tutorials, and more: https://ion.link/docs
- Building an enterprise app? Ionic has Enterprise Support and Features:
https://ion.link/enterprise-edition

C:\Users\Anon>cd myApp

C:\Users\Anon\myApp>ionic server
[ERROR] Unable to find command: server


   _             _
  (_) ___  _ __ (_) ___
  | |/ _ \| '_ \| |/ __|
  | | (_) | | | | | (__
  |_|\___/|_| |_|_|\___| CLI 6.16.3


  Usage:

    $ ionic <command> [<args>] [--help] [--verbose] [--quiet] [--no-interactive] [--no-color] [--confirm] [options]

  Global Commands:

    completion ...................... (experimental) Enables tab-completion for Ionic CLI
                                      commands.
    config <subcommand> ............. Manage CLI and project config values (subcommands: get,
                                      set, unset)
    deploy <subcommand> ............. (paid) Appflow Deploy functionality (subcommands: manifest)
    docs ............................ Open the Ionic documentation website
    info ............................ Print project, system, and environment information
    init ............................ (beta) Initialize existing projects with Ionic
    login ........................... Log in to Ionic
    logout .......................... Log out of Ionic
    signup .......................... Create an Ionic account
    ssh <subcommand> ................ Commands for configuring SSH keys (subcommands: add,
                                      delete, generate, list, setup, use)
    start ........................... Create a new project

  Project Commands:

    build ........................... Build web assets and prepare your app for any platform
                                      targets
    capacitor <subcommand> .......... Capacitor functionality (subcommands: add, build, copy,
                                      open, run, sync, update) (alias: cap)
    cordova <subcommand> ............ Cordova functionality (subcommands: build, compile,
                                      emulate, platform, plugin, prepare, requirements,
                                      resources, run) (alias: cdv)
    deploy <subcommand> ............. (paid) Appflow Deploy functionality (subcommands: add,
                                      build, configure)
    doctor <subcommand> ............. Commands for checking the health of your Ionic project
                                      (subcommands: check, list, treat)
    enterprise <subcommand> ......... (paid) Manage Ionic Enterprise features (subcommands:
                                      register)
    generate ........................ Automatically create framework features (alias: g)
    git <subcommand> ................ (paid) Commands relating to managing Appflow git
                                      (subcommands: remote)
    integrations <subcommand> ....... Manage various integrations in your app (subcommands:
                                      disable, enable, list) (aliases: i, integration)
    link ............................ (paid) Connect local apps to Ionic
    package <subcommand> ............ (paid) Appflow package functionality (subcommands: build,
                                      deploy)
    repair .......................... Remove and recreate dependencies and generated files
    serve ........................... Start a local dev server for app dev/testing (alias: s)
    ssl <subcommand> ................ (experimental) Commands for managing SSL keys &
                                      certificates (subcommands: generate)


C:\Users\Anon\myApp>ionic serve
> ng.cmd run app:serve --host=localhost --port=8100
[ng] - Generating browser application bundles (phase: setup)...
[ng] Compiling @angular/core : es2015 as esm2015
[ng] Compiling @angular/common : es2015 as esm2015
[ng] Compiling @angular/platform-browser : es2015 as esm2015
[ng] Compiling @angular/forms : es2015 as esm2015
[ng] Compiling @angular/platform-browser-dynamic : es2015 as esm2015
[ng] Compiling @angular/router : es2015 as esm2015
[ng] Compiling @ionic/angular : es2015 as esm2015
[ng] √ Browser application bundle generation complete.
[ng] Initial Chunk Files                                                | Names              |      Size
[ng] vendor.js                                                          | vendor             |   4.51 MB
[ng] polyfills.js                                                       | polyfills          | 621.81 kB
[ng] styles.css, styles.js                                              | styles             | 376.11 kB
[ng] main.js                                                            | main               |  16.19 kB
[ng] runtime.js                                                         | runtime            |  13.33 kB
[ng] | Initial Total      |   5.52 MB
[ng] Lazy Chunk Files                                                   | Names              |      Size
[ng] node_modules_ionic_core_dist_esm_swiper_bundle-6c5e7804_js.js      | -                  | 200.21 kB
[ng] polyfills-core-js.js                                               | polyfills-core-js  |  92.34 kB
[ng] node_modules_ionic_core_dist_esm_ion-datetime_3_entry_js.js        | -                  |  72.11 kB
[ng] node_modules_ionic_core_dist_esm_ion-item_8_entry_js.js            | -                  |  71.55 kB
[ng] node_modules_ionic_core_dist_esm_ion-app_8_entry_js.js             | -                  |  62.88 kB
[ng] node_modules_ionic_core_dist_esm_ion-slide_2_entry_js.js           | -                  |  56.35 kB
[ng] node_modules_ionic_core_dist_esm_ion-refresher_2_entry_js.js       | -                  |  47.35 kB
[ng] node_modules_ionic_core_dist_esm_ion-alert_entry_js.js             | -                  |  47.18 kB
[ng] node_modules_ionic_core_dist_esm_ion-segment_2_entry_js.js         | -                  |  37.29 kB
[ng] node_modules_ionic_core_dist_esm_ion-searchbar_entry_js.js         | -                  |  32.89 kB
[ng] node_modules_ionic_core_dist_esm_ion-nav_2_entry_js.js             | -                  |  32.30 kB
[ng] node_modules_ionic_core_dist_esm_ion-button_2_entry_js.js          | -                  |  32.09 kB
[ng] node_modules_ionic_core_dist_esm_ion-menu_3_entry_js.js            | -                  |  31.81 kB
[ng] node_modules_ionic_core_dist_esm_ion-item-option_3_entry_js.js     | -                  |  30.91 kB
[ng] node_modules_ionic_core_dist_esm_ion-action-sheet_entry_js.js      | -                  |  29.56 kB
[ng] node_modules_ionic_core_dist_esm_ion-range_entry_js.js             | -                  |  27.19 kB
[ng] node_modules_ionic_core_dist_esm_ion-modal_entry_js.js             | -                  |  26.48 kB
[ng] node_modules_ionic_core_dist_esm_ion-fab_3_entry_js.js             | -                  |  26.22 kB
[ng] node_modules_ionic_core_dist_esm_ion-route_4_entry_js.js           | -                  |  25.00 kB
[ng] node_modules_ionic_core_dist_esm_ion-select_3_entry_js.js          | -                  |  24.21 kB
[ng] node_modules_ionic_core_dist_esm_ion-tab-bar_2_entry_js.js         | -                  |  23.86 kB
[ng] node_modules_ionic_core_dist_esm_ion-progress-bar_entry_js.js      | -                  |  21.94 kB
[ng] node_modules_ionic_core_dist_esm_ion-toast_entry_js.js             | -                  |  21.57 kB
[ng] node_modules_ionic_core_dist_esm_ion-popover_entry_js.js           | -                  |  20.89 kB
[ng] node_modules_ionic_core_dist_esm_ion-input_entry_js.js             | -                  |  20.55 kB
[ng] polyfills-dom.js                                                   | polyfills-dom      |  19.42 kB
[ng] common.js                                                          | common             |  19.36 kB
[ng] node_modules_ionic_core_dist_esm_ion-textarea_entry_js.js          | -                  |  18.32 kB
[ng] node_modules_ionic_core_dist_esm_ion-virtual-scroll_entry_js.js    | -                  |  17.99 kB
[ng] node_modules_ionic_core_dist_esm_ion-toggle_entry_js.js            | -                  |  16.98 kB
[ng] node_modules_ionic_core_dist_esm_shadow-css-a3f00b33_js.js         | -                  |  15.91 kB
[ng] node_modules_ionic_core_dist_esm_ion-back-button_entry_js.js       | -                  |  15.77 kB
[ng] node_modules_ionic_core_dist_esm_ion-radio_2_entry_js.js           | -                  |  15.70 kB
[ng] node_modules_ionic_core_dist_esm_ion-card_5_entry_js.js            | -                  |  15.59 kB
[ng] node_modules_ionic_core_dist_esm_ion-col_3_entry_js.js             | -                  |  15.59 kB
[ng] node_modules_ionic_core_dist_esm_input-shims-73f15161_js.js        | -                  |  15.40 kB
[ng] node_modules_ionic_core_dist_esm_ion-loading_entry_js.js           | -                  |  14.95 kB
[ng] node_modules_ionic_core_dist_esm_ion-infinite-scroll_2_entry_js.js | -                  |  12.88 kB
[ng] node_modules_ionic_core_dist_esm_ion-reorder_2_entry_js.js         | -                  |  11.99 kB
[ng] node_modules_ionic_core_dist_esm_ion-checkbox_entry_js.js          | -                  |  11.41 kB
[ng] polyfills-css-shim.js                                              | polyfills-css-shim |  10.62 kB
[ng] node_modules_ionic_core_dist_esm_ion-chip_entry_js.js              | -                  |   9.80 kB
[ng] node_modules_ionic_core_dist_esm_ion-split-pane_entry_js.js        | -                  |   9.35 kB
[ng] node_modules_ionic_core_dist_esm_ion-spinner_entry_js.js           | -                  |   7.88 kB
[ng] src_app_tabs_tabs_module_ts.js                                     | -                  |   7.76 kB
[ng] node_modules_ionic_core_dist_esm_ion-tab_2_entry_js.js             | -                  |   7.75 kB
[ng] src_app_tab3_tab3_module_ts.js                                     | -                  |   7.09 kB
[ng] src_app_tab1_tab1_module_ts.js                                     | -                  |   6.81 kB
[ng] src_app_tab2_tab2_module_ts.js                                     | -                  |   6.81 kB
[ng] node_modules_ionic_core_dist_esm_ion-ripple-effect_entry_js.js     | -                  |   6.05 kB
[ng] node_modules_ionic_core_dist_esm_ion-avatar_3_entry_js.js          | -                  |   5.77 kB
[ng] node_modules_ionic_core_dist_esm_tap-click-cc1ae2b2_js.js          | -                  |   5.58 kB
[ng] node_modules_ionic_core_dist_esm_keyboard-5742b5da_js.js           | -                  |   5.34 kB
[ng] node_modules_ionic_core_dist_esm_ion-backdrop_entry_js.js          | -                  |   3.41 kB
[ng] node_modules_ionic_core_dist_esm_ion-img_entry_js.js               | -                  |   3.29 kB
[ng] node_modules_ionic_core_dist_esm_swipe-back-ee838cf8_js.js         | -                  |   2.74 kB
[ng] node_modules_ionic_core_dist_esm_focus-visible-f4ad4f1a_js.js      | -                  |   1.99 kB
[ng] node_modules_ionic_core_dist_esm_ion-text_entry_js.js              | -                  |   1.71 kB
[ng] node_modules_ionic_core_dist_esm_status-tap-bdecfebf_js.js         | -                  |   1.67 kB
[ng] Build at: 2021-07-05T08:47:21.110Z - Hash: abc89ae7796c9e4cfd2a - Time: 33661ms
[ng] √ Compiled successfully.

[INFO] Development server running!

       Local: http://localhost:8100

       Use Ctrl+C to quit this process

[INFO] Browser window opened to http://localhost:8100!

[ng] √ Browser application bundle generation complete.
[ng] 64 unchanged chunks
[ng] Build at: 2021-07-05T08:47:23.521Z - Hash: c7b6e1495dd09b663dd3 - Time: 1346ms
[ng] √ Compiled successfully.
[ng] Terminate batch job (Y/N)?
Terminate batch job (Y/N)? N

C:\Users\Anon\myApp>npm install -g cordova
npm WARN deprecated request@2.88.2: request has been deprecated, see https://github.com/request/request/issues/3142
npm WARN deprecated har-validator@5.1.5: this library is no longer supported
npm WARN deprecated uuid@3.4.0: Please upgrade  to version 7 or higher.  Older versions may use Math.random() in certain circumstances, which is known to be problematic.  See https://v8.dev/blog/math-random for details.
C:\Users\Anon\AppData\Roaming\npm\cordova -> C:\Users\Anon\AppData\Roaming\npm\node_modules\cordova\bin\cordova
+ cordova@10.0.0
added 491 packages from 265 contributors in 27.976s

C:\Users\Anon\myApp>cordova --version
? May Cordova anonymously report usage statistics to improve the tool over time? (Y/n)
You have been opted out of telemetry. To change this, run: cordova telemetry on.
10.0.0

C:\Users\Anon\myApp>ionic cordova plugin add cordova-plugin-battery-status

[WARN] About to integrate your app with Cordova.

       We now recommend Capacitor (https://ion.link/capacitor) as the official native runtime for
       Ionic. To learn about the differences between Capacitor and Cordova, see these docs[1].
       For a getting started guide, see these docs[2].

       [1]: https://ion.link/capacitor-differences-with-cordova-docs
       [2]: https://ion.link/capacitor-using-with-ionic-docs

? Are you sure you want to continue? Yes
> ionic integrations enable cordova
[INFO] Downloading integration cordova
[INFO] Copying integrations files to project
CREATE resources
CREATE resources\splash.png
CREATE resources\ios
CREATE resources\ios\splash
CREATE resources\ios\splash\Default~iphone.png
CREATE resources\ios\splash\Default@2x~universal~anyany.png
CREATE resources\ios\splash\Default@2x~iphone.png
CREATE resources\ios\splash\Default-Portrait~ipad.png
CREATE resources\ios\splash\Default-Portrait@~ipadpro.png
CREATE resources\ios\splash\Default-Portrait@2x~ipad.png
CREATE resources\ios\splash\Default-Landscape~ipad.png
CREATE resources\ios\splash\Default-Landscape@~ipadpro.png
CREATE resources\ios\splash\Default-Landscape@2x~ipad.png
CREATE resources\ios\splash\Default-Landscape-736h.png
CREATE resources\ios\splash\Default-Landscape-2436h.png
CREATE resources\ios\splash\Default-736h.png
CREATE resources\ios\splash\Default-667h.png
CREATE resources\ios\splash\Default-568h@2x~iphone.png
CREATE resources\ios\splash\Default-2436h.png
CREATE resources\ios\icon
CREATE resources\ios\icon\icon@2x.png
CREATE resources\ios\icon\icon.png
CREATE resources\ios\icon\icon-small@3x.png
CREATE resources\ios\icon\icon-small@2x.png
CREATE resources\ios\icon\icon-small.png
CREATE resources\ios\icon\icon-98@2x.png
CREATE resources\ios\icon\icon-86@2x.png
CREATE resources\ios\icon\icon-83.5@2x.png
CREATE resources\ios\icon\icon-76@2x.png
CREATE resources\ios\icon\icon-76.png
CREATE resources\ios\icon\icon-72@2x.png
CREATE resources\ios\icon\icon-72.png
CREATE resources\ios\icon\icon-60@3x.png
CREATE resources\ios\icon\icon-60@2x.png
CREATE resources\ios\icon\icon-60.png
CREATE resources\ios\icon\icon-50@2x.png
CREATE resources\ios\icon\icon-50.png
CREATE resources\ios\icon\icon-44@2x.png
CREATE resources\ios\icon\icon-40@3x.png
CREATE resources\ios\icon\icon-40@2x.png
CREATE resources\ios\icon\icon-40.png
CREATE resources\ios\icon\icon-29@3x.png
CREATE resources\ios\icon\icon-29@2x.png
CREATE resources\ios\icon\icon-29.png
CREATE resources\ios\icon\icon-27.5@2x.png
CREATE resources\ios\icon\icon-24@2x.png
CREATE resources\ios\icon\icon-20@3x.png
CREATE resources\ios\icon\icon-20@2x.png
CREATE resources\ios\icon\icon-20.png
CREATE resources\ios\icon\icon-1024.png
CREATE resources\icon.png
CREATE resources\android
CREATE resources\android\xml
CREATE resources\android\xml\network_security_config.xml
CREATE resources\android\splash
CREATE resources\android\splash\drawable-port-xxxhdpi-screen.png
CREATE resources\android\splash\drawable-port-xxhdpi-screen.png
CREATE resources\android\splash\drawable-port-xhdpi-screen.png
CREATE resources\android\splash\drawable-port-mdpi-screen.png
CREATE resources\android\splash\drawable-port-ldpi-screen.png
CREATE resources\android\splash\drawable-port-hdpi-screen.png
CREATE resources\android\splash\drawable-land-xxxhdpi-screen.png
CREATE resources\android\splash\drawable-land-xxhdpi-screen.png
CREATE resources\android\splash\drawable-land-xhdpi-screen.png
CREATE resources\android\splash\drawable-land-mdpi-screen.png
CREATE resources\android\splash\drawable-land-ldpi-screen.png
CREATE resources\android\splash\drawable-land-hdpi-screen.png
CREATE resources\android\icon
CREATE resources\android\icon\drawable-xxxhdpi-icon.png
CREATE resources\android\icon\drawable-xxhdpi-icon.png
CREATE resources\android\icon\drawable-xhdpi-icon.png
CREATE resources\android\icon\drawable-mdpi-icon.png
CREATE resources\android\icon\drawable-ldpi-icon.png
CREATE resources\android\icon\drawable-hdpi-icon.png
CREATE resources\README.md
CREATE config.xml
[OK] Integration cordova added!
√ Creating .\www directory for you in 2.78ms
> cordova.cmd plugin add cordova-plugin-battery-status
Adding cordova-plugin-battery-status to package.json

C:\Users\Anon\myApp>